6222222222222227
1000000000000003
1000000000000003
1000000000000003
1000000000000003
1000000000000003
1000000000000003
1000000000000003
1000000000000003
1000000000000003
1000000000000003
1000000000000003
1000000000000003
1000000000000003
1000000000000003
5444444444444448
5 5 amarillo
5 10 azul
10 5 verde
10 10 rojo
7 7 azul