6222222222222222222222227
1000000000000000000000003
1000000000000000000000003
1000000000000000000000003
1000000000000000000000003
1000000000000000000000003
1000000000000000000000003
1000000000000000000000003
1000000000000000000000003
1000000000000000000000003
1000000000000000000000003
1000000000000000000000003
1000000000000190000000003
1000000000000000000000003
1000000000000000000000003
1000000000000000000000003
1000000000000000000000003
1000000000000000000000003
1000000000007000000000003
1000000000005000000000003
1000000000000000000000003
1000000000000000000000003
1000000000000000000000003
1000000000000000000000003
5444444444444444444444448
1 2 rojo
3 22 azul
21 4 verde
22 23 amarillo
10 12 morado
18 12 multicolor