6222222222222222222222227
1000000000000000000000003
1000000000000000000000003
1000000000000000000000003
1000000000000000000000003
1000000060000000000000003
1000000050000000000000003
1000000000000000000000003
1000000000000000000000003
1000000000000000000000003
1000000000000000000000003
1000000000000000000000003
1000000000000007000000003
1000000000000004000000003
1000000000000000000000003
1000000000000000000000003
1000000000000000000000003
1000000000000000000000003
1000000000000000000000003
1000000000000000000000003
1000000000000000000000003
1000000000000000000000003
1000000000000000000000003
1000000000000000000000003
5444444444444444444444448
2 3 rojo
4 21 azul
11 6 verde
19 11 amarillo
23 22 morado
12 15 rojo