6222222222222222222222227
1000000000000000000000003
1000000000000000000000003
1000000000000000000000003
1000000000000000000000003
1000000000000000000000003
1000000000000000000000003
1000000000000000000000003
1000000000000000000000003
1000000000000000000000003
1000000000000000000000003
1000000000000000000000003
1000000000000000000000003
1000000000000000000000003
1000000000000000000000003
1000000000000000000000003
1000000000000000000000003
1000000000000000000000003
1000000000000000000000003
1000000000000000000000003
1000000000000000000000003
1000000000000000000000003
1000000000000000000000003
1000000000000000000000003
5444444444444444444444448
2 2 rojo
2 22 azul
22 2 verde
22 22 amarillo
12 12 morado
15 15 multicolor