6222222227
1000000003
1000000003
1000000003
1000000003
1000000003
1000000003
1000000003
1000000003
5444444448
1 1 rojo
2 2 azul
3 3 verde
8 8 amarillo
5 5 rojo