6222222227
1000000003
1000000003
1000000003
1000600003
1000500003
1000000003
1000000003
1000000003
5444444448
1 1 verde
2 8 rojo
8 2 azul
8 8 amarillo
4 5 azul