6222222227
1000070003
1000040003
1000000003
1000000003
1000000003
1000000003
1000000003
1006000003
5445444448
1 8 amarillo
2 2 azul
8 8 verde
7 7 rojo
8 1 amarillo